##########
#        #
# @      #
#        #
#    %   #
#        #
# %      #
#      @ #
#%       #
##########