##############################
#        #         #         #
# @      #   %%    #         #
#        #         #    %    #
#        #         #         #
#        #         #         #
#        #         #         #
#        #         #  %      #
#        #         #         #
##############################
#        #         #         #
#        #         #         #
#        #     %   #         #
#        #         #    @    #
#        #         #         #
#    @   #         #         #
#        #         #         #
#        #   %     #         #
##############################