##########
#@@@     #
# % #    #
#        #
#        #
#  %     #
#        #
#        #
#       @#
##########