##########
#@ @     #
# % #    #
#        #
#        #
#  %     #
#        #
#        #
#       @#
##########