##########
#@@@     #
# % #    #
#  #     #
##########